 ____________________ 
|                    |
| |                  |
|                    |
|                    |
|                    |
|                    |
|                    |
|                    |
|                    |
|____________________|